id	Name	Dept	English	San	Maths2A	Maths2B	physics	Chemisty	total
1	Anand	EEE	86	95	74	75	60	59	449
2	Priya	CSE	78	88	92	85	80	76	499
3	Rahul	MECH	90	85	80	70	65	60	450
4	Sneha	ECE	82	79	88	91	75	72	487
5	Vikram	CIVIL	85	80	78	82	77	74	476
6	Neha	IT	89	92	94	90	88	85	538
7	Arjun	EEE	76	81	79	83	70	68	457
8	Kavya	CSE	91	95	97	93	89	87	552
9	Rohan	MECH	80	78	75	72	70	68	443
10	Meera	ECE	88	85	90	87	82	80	512
